111111111111111111111111111111111111
101001010010000010100100000000000001
101001001010101000100100000011111111
1P0000000C00C000000C0000000010000011
1E0000000000000C00000C00000010000001
1010010100100C0010100100000001000001
101001001010101000100100000011100001
1C0000000C00100C00000C00000001100001
100000000100000000000100000000000001
100000000100000000000100000110000001
100000000100000000000100000011100001
100000000100000000000100000001000001
100000000100000000000100000011111111
100000000100000N00000100000010000011
100000C0010000000000000000C010000001
100100100100100001000000010010001001
111111111111111111111111111111111111